###########
#P#       #
# #       #
# # R     #
#         #
#    #### #
#         #
#         #
#       X #
#   R     #
###########
