##########
#P       #
#        #
#   R    #
#        #
#        #
#   R    #
#        #
#       X#
##########