###############
#             #
#             #
#    #####    #
#        #    #
#        #    #
#   R    #    #
#        #    #
#        #R  X#
###   ####  ###
#        #    #
#        #    #
#  P          #
#            R#
###############
